555555555555
555555555555
555555555555
555555555555
555111111555
555134241555
555140241555
555144431555
555111111555
555555555555
555555555555
555555555555