555555555555
555555555555
555511111555
555114231155
555132443155
555144444155
555144442155
555144244155
555132044155
555111111555
555555555555
555555555555