555555555555
555555555555
555555555555
555111111555
555134431555
555112241555
555102441555
555144431555
555111111555
555555555555
555555555555
555555555555