555555555555
555555555555
555555555555
555555111115
511111144315
514044444415
514411114415
514244424415
513441111115
511111555555
555555555555
555555555555