555555555555
555555555555
555511155555
555513115555
555114411155
551142423155
551342011155
551111215555
555551315555
555551115555
555555555555
555555555555